あっ	あっ	Ah!, Oh!
愛	あい	love
あいかわらず	あいかわらず	as ever, as usual, the same
愛情	あいじょう	love, affection
アイスクリーム	アイスクリーム	ice cream
愛する	あいする	to love
相手	あいて	companion, partner, company
アイデア/アイディア	アイデア/アイディア	idea
あいにく	あいにく	unfortunately, Sorry, but....
あいまい	あいまい	vague, ambiguous
アイロン	アイロン	(electric) iron
アウト	アウト	out
明かり	あかり	lamplight, light (in general), brightness
明らか	あきらか	obvious, evident, clear
明ける	あける	to dawn, to become daylight
挙げる	あげる	to raise, to fly
あげる (=やる)	あげる (=やる)	to do for
あした	あした	tomorrow
味わう	あじわう	to taste, to savor, to relish
預かる	あずかる	to keep in custody, to receive on deposit, to take charge of
預ける	あずける	to give into custody, to entrust, to deposit
汗	あせ	sweat, perspiration
与える	あたえる	to give, to present, to award
辺り	あたり	vicinity, nearby
あたりまえ	あたりまえ	usual, common, ordinary
当たる	あたる	to be hit, to be successful, to be equivalent to
あちこち	あちこち	here and there
あひら	あひら	
あちらこちら	あちらこちら	here and there
扱う	あつかう	to handle, to deal with, to treat
集まり	あつまり	gathering, meeting, assembly, collection
当てる	あてる	to hit, to apply a patch
あと	あと	(1) trace, tracks, (2) remains, ruins, (3) scar
穴	あな	hole
浴びる	あびる	to bathe, to bask in the sun, to shower
油	あぶら	oil
あふれる	あふれる	to flood, to overflow, to brim over
余る	あまる	to remain, to be left over, to be in excess, to be too many
危うい	あやうい	dangerous, critical, grave
嵐	あらし	storm, tempest
新た	あらた	new, fresh, novel
改めて	あらためて	another time, again, over again, anew, formally
改める	あらためる	to change, to alter, to reform, to revise
表す	あらわす	to express, to show, to reveal
現す	あらわす	to show, to indicate, to display
ありがとう	ありがとう	(conj, exp, int) Thank you
有る	ある	to be, to have
あるいは	あるいは	or, possibly
アルバム	アルバム	album
あれこれ	あれこれ	one thing or another, this and that, this or that
合わせる	あわせる	to join together, to be opposite, to face, to unite
案	あん	plan, suffix meaning draft
安定	あんてい	stability, equilibrium
アンテナ	アンテナ	antenna
案内	あんない	information, guidance, leading
胃	い	stomach
いい	いい	good
よい	よい	good, nice, pleasant, ok
いえ	いえ	TODO same as いいえ?
言い出す	いいだす	to start talking, to speak, to tell, to propose, to suggest, to break the ice
言い付ける	いいつける	to tell, to tell on (someone), to order
委員	いいん	committee member
言う	ゆう	to say
意外	いがい	unexpected, surprising
行き	いき	going
行き	ゆき	going
息	いき	breath, tone
意義	いぎ	meaning, significance
生き生き	いきいき	vividly, lively
勢い	いきおい	force, vigor, energy, spirit
いきなり	いきなり	(uk) abruptly, suddenly, all of a sudden, without warning
幾つ	いくつ	how many?, how old?
幾分	いくぶん	somewhat
幾ら	いくら	how much?, how many?
いけない	いけない	must not do, bad, wrong, not good
以後	いご	after this, from now on, hereafter, thereafter
以降	いこう	on and after, hereafter, thereafter
イコール	イコール	equal
医師	いし	doctor, physician
意思	いし	intention, purpose
意識	いしき	consciousness, senses
異常	いじょう	strangeness, abnormality, disorder
椅子	いす	chair
以前	いぜん	ago, since, before, previous
抱く	いだく	(sl) to embrace, to hug, to harbour, to entertain
いただきます	いただきます	expression of gratitude before meals
痛み	いたみ	pain, ache, sore, grief, distress
至る	いたる	to come, to arrive
位置	いち	place, situation, position, location
いちいち	いちいち	one by one, separately
一応	いちおう	once, tentatively, in outline, for the time being
一時	いちじ	moment, time
市場	いちば	(the) market (as a concept)
一番	いちばん	best, first, number one
一流	いちりゅう	first class, top grade, foremost, top-notch
いつか	いつか	sometime, someday, one day
一家	いっか	a house, a home, a family, a household
一種	いっしゅ	a species, a kind, a variety
いっていらっしゃい	いっていらっしゃい	
いってらっしゃい	いってらっしゃい	
いってまいります	いってまいります	
いつでも	いつでも	(at) any time, always, at all times, never (neg)
一般	いっぱん	general, liberal, universal, ordinary, average
一方	いっぽう	(1) on the other hand, (2) meanwhile, (3) only, simple, in turn
いつも	いつも	always, usually, every time, never (with neg. verb)
命	いのち	command, decree, life, destiny
今に	いまに	before long, even now
否	いや	no, the noes
嫌がる	いやがる	to hate, to dislike
依頼	いらい	(1) request, commission, dispatch, (2) dependence, trust
いらっしゃい	いらっしゃい	welcome
医療	いりょう	medical care, medical treatment
入れ物	いれもの	container, case, receptacle
祝い	いわい	celebration, festival
祝う	いわう	to congratulate, to celebrate
いわゆる	いわゆる	the so-called, so to speak
インク	インク	ink
インキ	インキ	ink
印象	いんしょう	impression
インタビュー	インタビュー	interview
ウイスキー	ウイスキー	whisky
ウーマン	ウーマン	woman
上	うわ	upper, outer, surface
ウエートレス	ウエートレス	waitress
飢える	うえる	to starve
魚	うお	fish
伺う	うかがう	(hon) to visit, to ask, to inquire
浮ぶ	うかぶ	to float, to rise to surface, to come to mind
浮かべる	うかべる	to float, to express, to look (sad, glad)
浮く	うく	to float, to become merry, to become loose
受け取る	うけとる	to receive, to get, to accept, to take
動かす	うごかす	to move, to shift
牛	うし	cattle, cow
失う	うしなう	to lose, to part with
後	うしろ	afterwards, since then, in the future
薄める	うすめる	to dilute, to water down
疑う	うたがう	to doubt, to distrust, to be suspicious of, to suspect
内	うち	inside
打合せ	うちあわせ	business meeting, previous arrangement, appointment
宇宙	うちゅう	universe, cosmos, space
撃つ	うつ	to attack, to defeat, to destroy
うっかり	うっかり	carelessly, thoughtlessly, inadvertently
映す	うつす	to project, to reflect, to cast (shadow)
移す	うつす	to remove, to transfer, to infect
訴える	うったえる	to sue (a person), to resort to, to appeal to
写る	うつる	to be photographed, to be projected
映る	うつる	to be reflected, to harmonize with, to come out (photo)
うどん	うどん	noodles (Japanese)
馬	うま	(1) horse, (2) promoted bishop (shogi)
うまい	うまい	delicious
生まれ	うまれ	birth, birth-place
埋める	うめる	to bury, to fill up, to fill (a seat, a vacant position)
裏返す	うらがえす	to turn inside out, to turn (something) over
裏口	うらぐち	backdoor, rear entrance
占う	うらなう	to forecast, to predict
売り切れ	うりきれ	sold-out
売り切れる	うりきれる	to be sold out
うるさい	うるさい	noisy, loud, fussy
売れる	うれる	to be sold
うん	（感）	fortune, luck
運	うん	fortune, luck
運転	うんてん	operation, motion, driving
運動	うんどう	motion, exercise
永遠	えいえん	eternity, perpetuity, immortality, permanence
影響	えいきょう	influence, effect
営業	えいぎょう	business, trade, management
栄養	えいよう	nutrition, nourishment
ええと	ええと	let me see, well, er....
笑顔	えがお	smiling face
描く	えがく	to draw, to paint, to sketch, to depict, to describe
エネルギー	エネルギー	(n) energy (de: Energie)
絵の具	えのぐ	colors, paints
得る	える	to get, to gain, to win
得る	うる	to get, to gain, to win
円	えん	circle, money
延期	えんき	postponement, adjournment
援助	えんじょ	assistance, aid, support
エンジン	エンジン	engine
演奏	えんそう	musical performance
遠足	えんそく	trip, hike, picnic
オイル	オイル	oil, engine oil, kerosene
王	おう	king, ruler, sovereign, monarch
追う	おう	to chase, to run after
応援	おうえん	aid, assistance, help, reinforcement
王様	おうさま	king
応じる	おうじる	to respond, to satisfy, to accept, to comply with, to apply for
応用	おうよう	application, put to practical use
終える	おえる	to finish
オーケストラ	オーケストラ	orchestra
オートメーション	オートメーション	automation
オーバー	オーバー	(1) overcoat, (2) over
オーバーコート	オーバーコート	
大家	おおや	rich family, distinguished family
お帰り	おかえり	return, welcome
おかず	おかず	side dish, accompaniment for rice dishes
お代わり	おかわり	second helping, another cup
おきのどくに	おきのどくに	
奥	おく	interior, inner part
おくさん	おくさん	(hon) wife, your wife, madam
贈る	おくる	to send, to give to, to award to, to confer on
起こる	おこる	to occur, to happen
おさきに	おさきに	before, ahead, previously
惜しい	おしい	regrettable, disappointing, precious
おじいさん	おじいさん	grandfather, male senior-citizen
おしゃれ	おしゃれ	smartly dressed, someone smartly dressed, fashion-conscious
おしゃべり	おしゃべり	chattering, talk, idle talk
おじゃまします	おじゃまします	Excuse me for disturbing you
おそらく	おそらく	perhaps
おだいじに	おだいじに	Take care of yourself
お互い	おたがい	mutual, reciprocal, each other
穏やか	おだやか	calm, gentle, quiet
お出掛け	おでかけ	
お手伝いさん	おてつだいさん	maid
男の人	おとこのひと	man
おととい	おととい	day before yesterday
おねがいします	おねがいします	please
おはよう	おはよう	(abbr) Good morning
お昼	おひる	lunch, noon
オフィス	オフィス	office
おまえ	おまえ	(fam) you (sing), presence (of a high personage)
おまたせしました	おまたせしました	Sorry to have kept you waiting
おまちください	おまちください	Please wait a moment
おめでとう	おめでとう	Congratulations!, an auspicious occasion!
思い掛けない	おもいがけない	unexpected, casual
思い出	おもいで	memories, recollections, reminiscence
思わず	おもわず	unintentional, spontaneous
おやすみ	おやすみ	(1) holiday, absence, rest, (2) (exp) Good night
及ぼす	およぼす	to exert, to cause, to exercise
下す	おろす	to lower, to let go down
音	おん	sound, note
温室	おんしつ	greenhouse
温度	おんど	temperature
女の人	おんなのひと	woman
蚊	か	mosquito
カー	カー	car
カード	カード	card, curd
カーブ	カーブ	(1) curve, (2) curve ball (baseball)
会	かい	meeting, assembly, party, association, club
回	かい	counter for occurrences
貝	かい	shell, shellfish
害	がい	injury, harm, evil influence, damage
会員	かいいん	member, the membership
絵画	かいが	picture
海外	かいがい	foreign, abroad, overseas
解決	かいけつ	settlement, solution, resolution
開始	かいし	start, commencement, beginning
回数	かいすう	number of times, frequency
回数券	かいすうけん	book of tickets
改正	かいせい	revision, amendment, alteration
解説	かいせつ	explanation, commentary
回転	かいてん	rotation, revolution, turning
解答	かいとう	answer, solution
解放	かいほう	release, liberation, emancipation
飼う	かう	to keep, to raise, to feed
抱える	かかえる	to hold or carry under or in the arms
掛かる	かかる	to take (e.g. time, money, etc), to hang
限る	かぎる	to restrict, to limit, to confine
描く	かく	to draw, to paint, to sketch, to depict, to describe
嗅ぐ	かぐ	to sniff, to smell
家具	かぐ	furniture
学	がく	learning, scholarship, erudition, knowledge
額	がく	forehead, brow
架空	かくう	aerial, overhead, fiction, fanciful
学者	がくしゃ	scholar
学習	がくしゅう	study, learning
隠す	かくす	to hide, to conceal
角度	かくど	angle
確認	かくにん	affirmation, confirmation
学年	がくねん	year in school, grade in school
学部	がくぶ	department of a university, undergraduate
確率	かくりつ	probability
学力	がくりょく	scholarship, knowledge, literary ability
隠れる	かくれる	to hide, to be hidden, to conceal oneself, to disappear
影	かげ	shade, shadow, other side
欠ける	かける	to be lacking
加減	かげん	addition and subtraction, allowance for
過去	かこ	the past, bygone days, the previous
火災	かさい	conflagration, fire
菓子	かし	pastry
家事	かじ	housework, domestic chores
賢い	かしこい	wise, clever, smart
歌手	かしゅ	singer
数	かず	number, figure
数える	かぞえる	to count
加速度	かそくど	acceleration
型	かた	mold, model, style, shape, data-type
肩	かた	shoulder
固い	かたい	stubborn, firm (not viscous or easily moved)
堅い	かたい	hard (esp. wood), steadfast, honorable, stuffy writing
硬い	かたい	solid, hard (esp. metal, stone), unpolished writing
方々	かたがた	persons, this and that, here and there, everywhere
塊	かたまり	lump, mass, clod, cluster
固まる	かたまる	to harden, to solidify, to become firm, to become certain
語る	かたる	to talk, to tell, to recite
勝ち	かち	win, victory
価値	かち	value, worth, merit
学科	がっか	study subject, course of study
学会	がっかい	scientific society, academic meeting
楽器	がっき	musical instrument
学期	がっき	term (school)
格好	かっこう	shape, form, posture, suitability
活字	かつじ	printing type
活動	かつどう	action, activity
活躍	かつやく	activity
過程	かてい	process
課程	かてい	course, curriculum
金	かね	(1) gold, (2) gold general (shogi) (abbr)
金持ち	かねもち	rich man
可能	かのう	possible, practicable, feasible
我慢	がまん	patience, endurance, perseverance
上	かみ	(1) first volume, (2) superior quality, (3) governmental
神様	かみさま	god
髪の毛	かみのけ	hair (head)
火曜	かよう	(abbr) Tuesday
空	から	sky
空っぽ	からっぽ	empty, vacant, hollow
川	かわ	river
河	かわ	river, stream
革	かわ	leather
代る	かわる	(v5r, vi) to take the place of, to relieve, to be substituted for
考え	かんがえ	thinking, thought, ideas, intention
感覚	かんかく	sense, sensation
観客	かんきゃく	audience, spectator(s)
環境	かんきょう	environment, circumstance
感激	かんげき	deep emotion, impression, inspiration
観光	かんこう	sightseeing
観察	かんさつ	observation, survey
感じ	かんじ	feeling, sense, impression
感謝	かんしゃ	thanks, gratitude
患者	かんじゃ	a patient
感情	かんじょう	emotion(s), feeling(s), sentiment
感じる	かんじる	to feel, to sense, to experience
感心	かんしん	admiration, Well done!
関する	かんする	to concern, to be related
完全	かんぜん	perfection, completeness
感想	かんそう	impressions, thoughts
関東	かんとう	eastern half of Japan, including Tokyo
感動	かんどう	being deeply moved, excitement, impression, deep emotion
管理	かんり	control, management (e.g. of a business)
完了	かんりょう	completion, conclusion
関連	かんれん	relation, connection, relevance
記憶	きおく	memory, recollection, remembrance
気温	きおん	temperature
議会	ぎかい	Diet, congress, parliament
期間	きかん	period, term
機関	きかん	organ, mechanism, facility, engine
企業	きぎょう	enterprise, undertaking
期限	きげん	term, period
機嫌	きげん	humour, temper, mood
記事	きじ	article, news story, report, account
記者	きしゃ	reporter
基準	きじゅん	standard, basis, criteria, norm
傷	きず	wound, injury, hurt, cut
基礎	きそ	foundation, basis
帰宅	きたく	returning home
気付く	きづく	to notice, to recognize, to become aware of
気に入る	きにいる	to be pleased with, to suit
記念	きねん	commemoration, memory
機能	きのう	function, faculty
気の毒	きのどく	pitiful, a pity
希望	きぼう	hope, wish, aspiration
基本	きほん	foundation, basis, standard
奇妙	きみょう	strange, queer, curious
疑問	ぎもん	question, problem, doubt, guess
逆	ぎゃく	reverse, opposite
九	きゅう	nine
旧	きゅう	ex-
休暇	きゅうか	holiday, day off, furlough
休業	きゅうぎょう	closed (e.g. store), business suspended, shutdown, holiday
急激	きゅうげき	sudden, precipitous, radical
急速	きゅうそく	rapid (e.g. progress)
休息	きゅうそく	rest, relief, relaxation
急に	きゅうに	
給料	きゅうりょう	salary, wages
器用	きよう	skillful, handy
教科書	きょうかしょ	text book
教師	きょうし	teacher (classroom)
教授	きょうじゅ	teaching, instruction, professor
共通	きょうつう	commonness, community
共同	きょうどう	cooperation, association, collaboration, joint
強力	きょうりょく	herculean strength, mountain carrier-guide
許可	きょか	permission, approval
漁業	ぎょぎょう	fishing (industry)
巨大	きょだい	huge, gigantic, enormous
嫌う	きらう	to hate, to dislike, to loathe
記録	きろく	record, minutes, document
議論	ぎろん	argument, discussion, dispute
気を付ける	きをつける	to be careful, to pay attention, to take care
金	きん	(1) gold, (2) gold general (shogi) (abbr)
銀	ぎん	(1) silver, silver coin, silver paint
禁煙	きんえん	No Smoking!
金額	きんがく	amount of money
金魚	きんぎょ	goldfish
禁止	きんし	prohibition, ban
金銭	きんせん	money, cash
近代	きんだい	present day
緊張	きんちょう	tension, mental strain, nervousness
筋肉	きんにく	muscle, sinew
金曜	きんよう	(abbr) Friday
九	く	nine
区域	くいき	limits, boundary, domain, zone, sphere, territory
食う	くう	(male) (vulg) to eat
偶然	ぐうぜん	(by) chance, unexpectedly, suddenly
空想	くうそう	daydream, fantasy, fancy, vision
空中	くうちゅう	sky, air
臭い	くさい	odour, scent, smell, stench
具体	ぐたい	concrete, tangible, material
下り	くだり	down-train (going away from Tokyo)
苦痛	くつう	pain, agony
工夫	くふう	labourer, worker
区別	くべつ	distinction, differentiation, classification
汲む	くむ	(1) to draw (water), to dip, to scoop, to pump
悔しい	くやしい	regrettable, mortifying, vexing
悔やむ	くやむ	to mourn
暮らし	くらし	living, livelihood, subsistence, circumstances
暮らす	くらす	to live, to get along
繰り返す	くりかえす	to repeat, to do something over again
苦しい	くるしい	painful, difficult
苦しむ	くるしむ	to suffer, to groan, to be worried
暮れ	くれ	year end, sunset, nightfall, end
苦労	くろう	troubles, hardships
詳しい	くわしい	knowing very well, detailed, full, accurate
軍	ぐん	army, force, troops
訓練	くんれん	practice, training
下	げ	under, below, beneath
計	けい	plan
計画	けいかく	plan, project, schedule, scheme, program
景気	けいき	condition, state, business (condition)
経験	けいけん	experience
計算	けいさん	calculation, reckoning
掲示	けいじ	notice, bulletin
継続	けいぞく	continuation
経度	けいど	longitude
欠陥	けっかん	defect, fault, deficiency
結局	けっきょく	after all, eventually
決心	けっしん	determination, resolution
決定	けってい	decision, determination
欠点	けってん	faults, defect, weakness
結論	けつろん	conclusion
気配	けはい	indication, market trend, worry
下品	げひん	vulgarity, meanness, indecency, coarseness
煙い	けむい	smoky
煙	けむり	smoke, fumes
けれど/けれども		but, however
県	けん	prefecture
見解	けんかい	opinion, point of view
限界	げんかい	limit, bound
原稿	げんこう	manuscript, copy
検査	けんさ	inspection (e.g. customs, factory), examination
現在	げんざい	present, up to now, nowadays, modern times, current
現実	げんじつ	reality
現象	げんしょう	phenomenon
現状	げんじょう	present condition, existing state, status quo
建設	けんせつ	construction, establishment
現代	げんだい	nowadays, modern times, present-day
建築	けんちく	construction, architecture
限度	げんど	limit, bounds
現場	げんば	actual spot, scene, scene of the crime
原理	げんり	principle, theory, fundamental truth
後	ご	afterwards, since then, in the future
語	ご	language, word
恋	こい	love, tender passion
濃い	こい	thick (as of color, liquid), dense, strong
恋しい	こいしい	(1) dear, beloved, darling, (2) yearned for
恋人	こいびと	lover, sweetheart
工員	こういん	factory worker
幸運	こううん	good luck, fortune
効果	こうか	effect, effectiveness, efficacy, result
高価	こうか	high price
合格	ごうかく	success, passing (e.g. exam), eligibility
交換	こうかん	exchange, interchange, reciprocity
高級	こうきゅう	high class, high grade
公共	こうきょう	public, community, public service, society, communal
航空	こうくう	aviation, flying
光景	こうけい	scene, spectacle
合計	ごうけい	sum total, total amount
攻撃	こうげき	attack, strike, offensive, criticism, censure
広告	こうこく	advertisement
工事	こうじ	construction work
公式	こうしき	formula, formality, official
工場	こうば	factory, plant, mill, workshop
公正	こうせい	justice, fairness, impartiality
高速	こうそく	high speed, high gear
交通機関	こうつうきかん	transportation facilities
高度	こうど	altitude, height, advanced
行動	こうどう	action, conduct, behaviour, mobilization
幸福	こうふく	happiness, blessedness
公平	こうへい	fairness, impartial, justice
項目	こうもく	item
紅葉	こうよう	(1) (Japanese) maple
合理	ごうり	rational
交流	こうりゅう	alternating current, intercourse, (cultural) exchange, intermingling
合流	ごうりゅう	confluence, union, linking up, merge
越える	こえる	to exceed, to cross over, to cross
超える	こえる	to exceed, to cross over, to cross
氷	こおり	ice, hail
凍る	こおる	to freeze, to be frozen over, to congeal
誤解	ごかい	misunderstanding
語学	ごがく	language study
呼吸	こきゅう	breath, respiration
故郷	こきょう	home town, birthplace, old village, historic village
極	ごく	quite, very
国語	こくご	national language
国民	こくみん	national, people, citizen
国立	こくりつ	national
ここ	ここ	here
心当たり	こころあたり	having some knowledge of, happening to know
腰	こし	hip
個人	こじん	individual, private person, personal, private
国家	こっか	state, country, nation
国会	こっかい	National Diet, parliament, congress
国境	こっきょう	national or state border
骨折	こっせつ	bone fracture
事	こと	thing, matter, fact, circumstances
異なる	ことなる	to differ, to vary, to disagree
断る	ことわる	to refuse, to decline, to dismiss
この	この	this
好み	このみ	liking, taste, choice
好む	このむ	to like, to prefer
娯楽	ごらく	pleasure, amusement
殺す	ころす	to kill
転ぶ	ころぶ	to fall down, to fall over
今回	こんかい	now, this time, lately
今後	こんご	from now on, hereafter
混雑	こんざつ	confusion, congestion
今日	こんにち	today, this day
婚約	こんやく	engagement, betrothal
最高	さいこう	highest, supreme, the most
最終	さいしゅう	last, final, closing
最中	さいちゅう	in the middle of
才能	さいのう	talent, ability
作業	さぎょう	work, operation, manufacturing, fatigue duty
作品	さくひん	work, opus, performance, production
桜	さくら	cherry blossom, cherry tree
酒	さけ	alcohol, sake
避ける	さける	(1) to avoid (physical contact ), (2) to ward off, to avert
刺す	さす	to pierce, to stab, to prick, to thrust
指す	さす	to point, to put up umbrella, to play
座席	ざせき	seat
誘う	さそう	(1) to invite, to ask, (2) to tempt, to lure, to induce
札	さつ	(1) token, label, (2) ticket, (3) charm
作家	さっか	author, writer, novelist, artist
作曲	さっきょく	composition, setting (of music)
差別	さべつ	discrimination, distinction, differentiation
様々	さまざま	varied, various
覚ます	さます	to awaken
覚める	さめる	to wake, to wake up
左右	さゆう	(1) left and right, (2) influence, control, domination
皿	さら	plate, dish
再来月	さらいげつ	month after next
再来週	さらいしゅう	week after next
再来年	さらいねん	year after next
更に	さらに	furthermore, again, after all, more and more, moreover
去る	さる	to leave, to go away
参加	さんか	participation
三角	さんかく	triangle, triangular
参考	さんこう	reference, consultation
産地	さんち	producing area
散歩	さんぽ	walk, stroll
四	し	four
仕上がる	しあがる	to be finished
しいんと	（する）	silent (as the grave), (deathly) quiet
叱る	しかる	to scold
四季	しき	four seasons
時期	じき	time, season, period
刺激	しげき	stimulus, impetus, incentive
事件	じけん	event, affair, incident
事実	じじつ	fact, truth, reality
事情	じじょう	circumstances, consideration, conditions, situation, reasons
自身	じしん	by oneself, personally
沈む	しずむ	to sink, to feel depressed
姿勢	しせい	attitude, posture
自然	しぜん	nature, spontaneous
思想	しそう	thought, idea
死体	したい	corpse
事態	じたい	situation, present state of affairs
従う	したがう	to abide (by the rules), to obey, to follow, to accompany
親しい	したしい	intimate, close (e.g. friend)
七	しち	seven
質	しつ	quality, nature (of person)
失業	しつぎょう	unemployment
実験	じっけん	experiment
実現	じつげん	implementation, materialization, realization
実行	じっこう	practice, performance, execution (e.g. program), realization
実際	じっさい	practical, actual condition, status quo
実施	じっし	enforcement, enact, put into practice, carry out, operation
実習	じっしゅう	practice, training
実物	じつぶつ	real thing, original
失恋	しつれん	disappointed love, broken heart, unrequited love, be lovelorn
指定	してい	designation, specification, assignment, pointing at
指導	しどう	leadership, guidance, coaching
自動	じどう	automatic, self-motion
児童	じどう	children, juvenile
品	しな	thing, article, goods, dignity, article (goods), counter for meal courses
支配	しはい	rule, control, direction
支払う	しはらう	to pay
死亡	しぼう	death, mortality
絞る	しぼる	to press, to wring, to squeeze
しまう	（終わる）	to finish, to close, to do something completely
しまった	（感）	Damn it!
自慢	じまん	pride, boast
事務	じむ	business, office work
締切	しめきり	closing, cut-off, end, deadline, Closed, No Entrance
締め切る	しめきる	to shut up
示す	しめす	to denote, to show, to point out, to indicate
占める	しめる	(1) to comprise, to account for, to make up (of), (2) to hold, to occupy
下	しも	under, below, beneath
弱点	じゃくてん	weak point, weakness
週	しゅう	week
十	じゅう	10, ten
銃	じゅう	gun
週間	しゅうかん	week, weekly
宗教	しゅうきょう	religion
集合	しゅうごう	gathering, assembly, meeting, set (math)
重視	じゅうし	importance, stress, serious consideration
就職	しゅうしょく	finding employment, inauguration
修正	しゅうせい	amendment, correction, revision, modification
重体	じゅうたい	seriously ill, serious condition, critical state
重大	じゅうだい	serious, important, grave, weighty
住宅	じゅうたく	resident, housing
集団	しゅうだん	group, mass
集中	しゅうちゅう	concentration, focusing the mind
終点	しゅうてん	terminus, last stop (e.g train)
重点	じゅうてん	important point, lay stress on, colon, emphasis
収入	しゅうにゅう	income, receipts, revenue
周辺	しゅうへん	circumference, outskirts, environs, (computer) peripheral
重役	じゅうやく	director, high executive
重要	じゅうよう	important, momentous, essential, principal, major
終了	しゅうりょう	end, close, termination
重量	じゅうりょう	(1) weight, (2) heavyweight boxer
重力	じゅうりょく	gravity
受験	じゅけん	taking an examination
手術	しゅじゅつ	surgical operation
主張	しゅちょう	claim, request, insistence, assertion
出勤	しゅっきん	going to work, at work
出身	しゅっしん	graduate from, come from
出張	しゅっちょう	official tour, business trip
出発	しゅっぱつ	departure
出版	しゅっぱん	publication
首都	しゅと	capital city
主婦	しゅふ	housewife, mistress
種類	しゅるい	variety, kind, type
準備	じゅんび	preparation, arrangements, provision, reserve
使用	しよう	use, application, employment, utilization
小	しょう	
上	じょう	(1) first volume, (2) superior quality, (3) governmental
障害	しょうがい	obstacle, impediment (fault), damage
小学生	しょうがくせい	grade school student
乗客	じょうきゃく	passenger
状況	じょうきょう	state of affairs, situation, circumstances
条件	じょうけん	conditions, terms
少女	しょうじょ	daughter, young lady, virgin, maiden, little girl
少々	しょうしょう	just a minute, small quantity
症状	しょうじょう	symptoms, condition
生じる	しょうじる	to produce, to yield, to result from, to arise, to be generated
招待	しょうたい	invitation
状態	じょうたい	condition, situation, circumstances, state
冗談	じょうだん	jest, joke
承知	しょうち	consent, acceptance, assent, admitting
焦点	しょうてん	focus, point
承認	しょうにん	recognition, acknowledgement, approval, consent, agreement
少年	しょうねん	boys, juveniles
商売	しょうばい	trade, business, commerce, transaction, occupation
商品	しょうひん	commodity, article of commerce, goods, stock, merchandise
勝負	しょうぶ	victory or defeat, match, contest, game, bout
消防署	しょうぼうしょ	fire station
情報	じょうほう	information, (military) intelligence
証明	しょうめい	proof, verification
正面	しょうめん	the front, honesty
初級	しょきゅう	elementary level
職	しょく	employment
職業	しょくぎょう	occupation, business
食事	しょくじ	meal
食品	しょくひん	commodity, foodstuff
食欲	しょくよく	appetite (for food)
書店	しょてん	bookshop
処理	しょり	processing, dealing with, treatment, disposition, disposal
書類	しょるい	documents, official papers
白髪	しらが	white or grey hair, trendy hair bleaching
知らせ	しらせ	notice
尻	しり	buttocks, bottom
知合い	しりあい	acquaintance
私立	しりつ	private (establishment)
進学	しんがく	going on to university
新幹線	しんかんせん	bullet train (very high speed), shinkansen
神経	しんけい	nerve, sensitivity
真剣	しんけん	seriousness, earnestness
信号	しんごう	traffic lights, signal, semaphore
人工	じんこう	artificial, manmade, human work, human skill, artificiality
人種	じんしゅ	race (of people)
信じる	しんじる	to believe, to place trust in
人生	じんせい	(human) life (i.e. conception to death)
新鮮	しんせん	fresh
身体	しんたい	the body
診断	しんだん	diagnosis
身長	しんちょう	height (of body), stature
人物	じんぶつ	character, personality, person, man, personage, talented man
進歩	しんぽ	progress, development
信用	しんよう	confidence, dependence, credit, faith
人類	じんるい	mankind, humanity
図	ず	figure (e.g. Fig 1), drawing, picture, illustration
水準	すいじゅん	(1) water level, (2) level, standard
水筒	すいとう	canteen, flask, water bottle
睡眠	すいみん	sleep
数	すう	number, figure
数字	すうじ	numeral, figure
姿	すがた	figure, shape, appearance
好き嫌い	すききらい	likes and dislikes, taste
優れる	すぐれる	to surpass, to outstrip, to excel
筋	すじ	muscle, string, line
進める	すすめる	to advance, to promote, to hasten
既に	すでに	already, too late
棄てる	すてる	
素直	すなお	obedient, meek, docile, unaffected
全て	すべて	all, the whole, entirely, in general, wholly
角	すみ	horn
すみません	（感）	sorry, excuse me
澄む	すむ	to clear (e.g. weather), to become transparent
鋭い	するどい	pointed, sharp
背	せい	height, stature
正	せい	(logical) true, regular
生	せい	(1) draft (beer), (2) raw, unprocessed
性	せい	sex, gender
税	ぜい	
性格	せいかく	character, personality
請求	せいきゅう	claim, demand, application, request
税金	ぜいきん	tax, duty
清潔	せいけつ	clean
生産	せいさん	production, manufacture
正式	せいしき	due form, official, formality
性質	せいしつ	nature, property, disposition
精神	せいしん	mind, soul, heart, spirit, intention
成人	せいじん	adult
成績	せいせき	results, record
製造	せいぞう	manufacture, production
贅沢	ぜいたく	luxury, extravagance
成長	せいちょう	growth, grow to adulthood
生長	せいちょう	growth, increment
制度	せいど	system, institution, organization
性能	せいのう	ability, efficiency
製品	せいひん	manufactured goods, finished goods
政府	せいふ	government, administration
生物	せいぶつ	raw food
成分	せいぶん	ingredient, component, composition
性別	せいべつ	distinction by sex, sex, gender
正方形	せいほうけい	square
生命	せいめい	life, existence
整理	せいり	sorting, arrangement, adjustment, regulation
咳	せき	cough
石油	せきゆ	oil, petroleum, kerosene
世間	せけん	world, society
設計	せっけい	plan, design
接続	せつぞく	(1) connection, union, join, link, (2) changing trains
絶対	ぜったい	absolute, unconditional, absoluteness
設備	せつび	equipment, device, facilities, installation
節約	せつやく	economising, saving
世話	せわ	looking after, help, aid, assistance
全	ぜん	all, whole, entire, complete, overall, pan
全員	ぜんいん	all members (unanimity), all hands, the whole crew
前後	ぜんご	around, throughout, front and back, before and behind, before and after
全国	ぜんこく	country-wide, nation-wide, whole country, national
選手	せんしゅ	(1) player (in game), (2) team
全集	ぜんしゅう	complete works
全身	ぜんしん	the whole body, full-length (portrait)
選択	せんたく	selection, choice
宣伝	せんでん	propaganda, publicity
象	ぞう	elephant
雑巾	ぞうきん	house-cloth, dust cloth
操作	そうさ	operation, management, processing
想像	そうぞう	imagination, guess
装置	そうち	equipment, installation, apparatus
相当	そうとう	suitable, fair, tolerable, proper
属する	ぞくする	to belong to, to come under, to be affiliated with, to be subject to
速度	そくど	speed, velocity, rate
そこ	そこ	bottom, sole
底	そこ	bottom, sole
注ぐ	そそぐ	to pour (into), to irrigate, to pay, to fill, to feed (e.g. a fire)
育つ	そだつ	to raise (child), to be brought up, to grow (up)
備える	そなえる	to furnish, to provide for, to equip, to install
その	その	the, that
側	そば	side, edge, third person
それ	（接。感）	it, that
揃う	そろう	to become complete, to be equal, to be all present, to gather
揃える	そろえる	to put things in order, to arrange, to make uniform, to get something ready
損	そん	loss, disadvantage
損害	そんがい	damage, injury, loss
尊敬	そんけい	respect, esteem, reverence, honour
存在	そんざい	existence, being
田	た	rice field
他	た	other (esp. places and things)
対	たい	pair, couple, set
大	だい	
台	だい	stand, rack, table, support
題	だい	title, subject, theme, topic
体育	たいいく	physical education, gymnastics, athletics
だいいち	（副）	first, foremost, # 1
体温	たいおん	temperature (body)
大会	たいかい	convention, tournament, mass meeting, rally
大学院	だいがくいん	graduate school
代金	だいきん	price, payment, cost, charge
大工	だいく	carpenter
退屈	たいくつ	tedium, boredom
対策	たいさく	counter-plan, counter-measure
大した	たいした	considerable, great, important, significant, a big deal
大して	たいして	(not so) much, (not) very
対象	たいしょう	target, object (of worship, study, etc), subject (of taxation, etc)
大小	だいしょう	size
対する	たいする	to face, to confront, to oppose
体制	たいせい	order, system, structure, set-up, organization
体操	たいそう	gymnastics, physical exercises, calisthenics
大抵	たいてい	usually, generally
態度	たいど	attitude, manner
大半	たいはん	majority, mostly, generally
代表	だいひょう	representative, representation, delegation, type, example, model
大部分	だいぶぶん	most part, greater part, majority
逮捕	たいほ	arrest, apprehension, capture
太陽	たいよう	sun, solar
代理	だいり	representation, agency, proxy, deputy, agent
倒す	たおす	to throw down, to beat, to bring down, to blow down
だが	だが	
互い	たがい	mutual, reciprocal
高める	たかめる	to raise, to lift, to boost
だから	だから	so, therefore
滝	たき	waterfall
宅	たく	house, home, husband
確かめる	たしかめる	to ascertain
多少	たしょう	more or less, somewhat, a little, some
助かる	たすかる	to be saved, to be rescued, to survive, to be helpful
助ける	たすける	to help, to save, to rescue
叩く	たたく	to strike, to clap, to dust, to beat
立場	たちば	standpoint, position, situation
達する	たっする	to reach, to get to
例える	たとえる	to compare, to liken, to speak figuratively, to illustrate, to use a simile
他人	たにん	another person, unrelated person, outsider, stranger
種	たね	(1) seed, (2) material, (3) cause, source
度	たび	counter for occurrences
旅	たび	travel, trip, journey
多分	たぶん	perhaps, probably
玉	たま	ball, sphere, coin
偶	たま	even number, couple, man and wife, friend
偶々	たまたま	casually, unexpectedly, accidentally, by chance
黙る	だまる	to be silent
駄目	だめ	useless, no good, hopeless
試し	ためし	trial, test
試す	ためす	to attempt, to test
溜める	ためる	to amass, to accumulate
頼る	たよる	to rely on, to have recourse to, to depend on
足る	たる	to be sufficient, to be enough
誰か	だれか	someone, somebody
段	だん	step, stair, flight of steps, grade, rank, level
単位	たんい	unit, denomination, credit (in school)
段階	だんかい	gradation, grade, stage
単純	たんじゅん	simplicity
短所	たんしょ	(1) defect, demerit, weak point, (2) disadvantage
誕生	たんじょう	birth
団体	だんたい	organization, association
担当	たんとう	(in) charge
単なる	たんなる	mere, simple, sheer
地	ち	earth
地位	ちい	(social) position, status
地域	ちいき	area, region
違い	ちがい	difference, discrepancy
違いない	ちがいない	(phrase) sure, no mistaking it, for certain
地下水	ちかすい	underground water
地球	ちきゅう	the earth
地区	ちく	district, section, sector
知識	ちしき	knowledge, information
地質	ちしつ	geological features
父親	ちちおや	father
地点	ちてん	site, point on a map
知能	ちのう	intelligence, brains
地方	ちほう	area, locality, district, region, the coast
地名	ちめい	place name
茶	ちゃ	tea
茶色い	ちゃいろい	
着々	ちゃくちゃく	steadily
中	ちゅう	inside, middle, among
中央	ちゅうおう	centre, central, center, middle
中学	ちゅうがく	middle school, junior high school
中間	ちゅうかん	middle, midway, interim
中古	ちゅうこ	(1) used, second-hand, old
中止	ちゅうし	suspension, stoppage, discontinuance, interruption
駐車	ちゅうしゃ	parking (e.g. car)
昼食	ちゅうしょく	lunch, midday meal
中心	ちゅうしん	center, core, heart, pivot, emphasis, balance
中性	ちゅうせい	neuter gender, neutral (chem.), indifference, sterility
中年	ちゅうねん	middle-aged
注文	ちゅうもん	order, request
長期	ちょうき	long time period
彫刻	ちょうこく	carving, engraving, sculpture
調査	ちょうさ	investigation, examination, inquiry, survey
長所	ちょうしょ	(1) strong point, merit, (2) advantage
調整	ちょうせい	regulation, adjustment, tuning
調節	ちょうせつ	regulation, adjustment, control
長短	ちょうたん	length, long and short, +-
頂点	ちょうてん	top, summit
直接	ちょくせつ	direct, immediate, personal, firsthand
追加	ついか	addition, supplement, appendix
通過	つうか	passage through, passing
通勤	つうきん	commuting to work
通行	つうこう	passage, passing
通じる	つうじる	to run to, to lead to, to communicate, to understand
通信	つうしん	correspondence, communication, news, signal
通知	つうち	notice, notification
通用	つうよう	popular use, circulation
掴む	つかむ	to seize, to catch, to grasp
疲れ	つかれ	tiredness, fatigue
月	つき	moon, month
付き合い	つきあい	association, socializing, fellowship
次々	つぎつぎ	in succession, one by one
月日	つきひ	time, years, days
突く	つく	(1) to thrust, to strike, (2) to poke
次ぐ	つぐ	to rank next to, to come after
注ぐ	つぐ	to pour (into), to irrigate, to pay
作る/造る	つくる	to make, to create
付ける	つける	to attach, to join, to add, to append
着ける	つける	(1) to attach, to join, to add, to append
土	つち	earth, soil
包み	つつみ	bundle, package, parcel, bale
務める	つとめる	(1) to serve, to fill a post, to serve under, to work (for)
努める	つとめる	(1) to serve, to fill a post, to serve under, to work (for)
常に	つねに	always, constantly
潰す	つぶす	to smash, to waste
潰れる	つぶれる	to be smashed, to go bankrupt
詰まる	つまる	to be blocked, to be packed
罪	つみ	crime, fault, indiscretion
積む	つむ	to pile up, to stack
爪	つめ	fingernail or toenail, claw, talon, hoof
詰める	つめる	to pack, to shorten, to work out (details)
梅雨	つゆ	rainy season, rain during the rainy season
辛い	つらい	painful, heart-breaking
連れ	つれ	companion, company
出会い	であい	meeting, rendezvous, encounter
出合い	であい	an encounter
出会う	であう	to meet by chance, to come across, to happen to encounter
手洗い	てあらい	restroom, lavatory, hand-washing
定員	ていいん	fixed number of regular personnel, capacity (of boat, etc.)
定価	ていか	established price
定期	ていき	fixed term
定期券	ていきけん	commuter pass, season ticket
定休日	ていきゅうび	regular holiday
抵抗	ていこう	electrical resistance, resistance, opposition
停車	ていしゃ	stopping (e.g. train)
停電	ていでん	failure of electricity
程度	ていど	degree, amount, grade, standard, of the order of (following a number)
出入り	でいり	in and out, coming and going, free association, income and expenditure, debits and credit
出入口	でいりぐち	exit and entrance
的確	てきかく	precise, accurate
出来事	できごと	incident, affair, happening, event
適切	てきせつ	pertinent, appropriate, adequate, relevance
できる	（可能。出現。発生）	to be able to, to be ready, to occur
手首	てくび	wrist
手帳	てちょう	notebook
手伝い	てつだい	help, helper, assistant
手続き	てつづき	procedure, (legal) process, formalities
鉄道	てつどう	railroad
では	では	chance of going out, opportunity (to succeed), moment of departure, beginning of work
手間	てま	time, labour
でも	でも	but, however
伝記	でんき	biography, life story
電子	でんし	electron
点数	てんすう	marks, points, score, runs
電力	でんりょく	electric power
度	ど	counter for occurrences
問い	とい	question, query
どう	（接。副）	child, servant, foolishness
動作	どうさ	action, movements, motions, bearing, behaviour, manners
当時	とうじ	at that time, in those days
動詞	どうし	verb
同時	どうじ	simultaneous(ly), concurrent, same time, synchronous
当日	とうじつ	appointed day, very day
登場	とうじょう	entry (on stage)
同僚	どうりょう	coworker, colleague, associate
道路	どうろ	road, highway
十	とお	10, ten
通す	とおす	to let pass, to overlook, to continue
通り	とおり	in accordance with ~, following ~, ~ Street, ~ Avenue
都会	とかい	city
時	とき	(1) time, hour, (2) occasion, moment
解く	とく	to unfasten
得意	とくい	pride, triumph, prosperity
特殊	とくしゅ	special, unique
読書	どくしょ	reading
独身	どくしん	bachelorhood, single, unmarried, celibate
特徴	とくちょう	feature, characteristic
特定	とくてい	specific, special, particular
独特	どくとく	peculiarity, uniqueness, characteristic
独立	どくりつ	independence (e.g. Ind. Day), self-support
解ける	とける	to come untied, to come apart
登山	とざん	mountain-climbing
都市	とし	town, city, municipal, urban
閉じる	とじる	to close (e.g. book, eyes), to shut
土地	とち	plot of land, lot, soil
突然	とつぜん	abruptly, suddenly, unexpectedly, all at once
届く	とどく	to reach
整う	ととのう	to be prepared, to be in order, to be put in order, to be arranged
留まる	とどまる	(1) to be fixed, (2) to abide, to stay (in the one place)
留まる	とまる	(1) to be fixed, (2) to abide, to stay (in the one place)
留める	とめる	to fasten, to turn off, to detain
土曜	どよう	Saturday
努力	どりょく	great effort, exertion, endeavour, effort
採る	とる	(1) to adopt (measure, proposal), (2) to pick (fruit)
どれ	どれ	well, now, let me see, which (of three or more)
取れる	とれる	to come off, to be taken off, to be removed
名	な	name, reputation
内科	ないか	internist clinic, internal medicine
内容	ないよう	subject, contents, matter, substance, detail, import
半ば	なかば	middle, half, semi, halfway, partly
仲間	なかま	company, fellow, colleague, associate
眺め	ながめ	scene, view, prospect, outlook
眺める	ながめる	to view, to gaze at
流れ	ながれ	stream, current
流れる	ながれる	to stream, to flow, to run (ink), to be washed away
亡くす	なくす	to lose someone, wife, child, etc
無し	なし	without
納得	なっとく	consent, assent, understanding
等	など	et cetera, etc., and the like
七	なな	seven
何	なに	what
何	なん	what
何か	なにか	something
生	なま	(1) draft (beer), (2) raw, unprocessed
悩む	なやむ	to be worried, to be troubled
何とか	なんとか	somehow, anyhow, one way or another
似合う	にあう	to suit, to match, to become, to be like
匂い	におい	odour, scent, smell, stench
匂う	におう	to be fragrant, to smell, to stink
握る	にぎる	to grasp, to seize, to mould sushi
日	にち	sun, sunshine, day
日時	にちじ	date and time
日常	にちじょう	ordinary, regular, everyday, usual
日曜	にちよう	Sunday
日光	にっこう	sunlight
日中	にっちゅう	daytime, broad daylight
日程	にってい	agenda
日本	にっぽん	Japan
日本	にほん	Japan
入院	にゅういん	hospitalization
入学	にゅうがく	entry to school or university, matriculation
入社	にゅうしゃ	entry to a company
人気	にんき	sign of life
抜く	ぬく	to extract, to omit, to surpass, to draw out, to unplug
抜ける	ぬける	to come out, to fall out, to be omitted
布	ぬの	cloth
ね	（感）	value, price, cost, worth, merit
根	ね	root
値	ね	value, price, cost
願い	ねがい	desire, wish, request
願う	ねがう	to desire, to wish, to request
捩る	ねじる	to twist
熱心	ねっしん	zeal, enthusiasm
年代	ねんだい	age, era, period, date
年度	ねんど	year, fiscal year, school year, term
年齢	ねんれい	age, years
野	の	field
能	のう	being skilled in, nicely, properly
農家	のうか	farmer, farm family
農業	のうぎょう	agriculture
農産物	のうさんぶつ	agricultural produce
農村	のうそん	agricultural community, farm village, rural
濃度	のうど	concentration, brightness
農民	のうみん	farmers, peasants
能率	のうりつ	efficiency
能力	のうりょく	ability, faculty
ノー	（no）	
残す	のこす	to leave (behind, over), to bequeath, to save, to reserve
除く	のぞく	to remove, to exclude, to except
望み	のぞみ	wish, desire, (a) hope
望む	のぞむ	to desire, to wish for, to see, to command (a view of)
後	のち	afterwards, since then, in the future
伸ばす	のばす	to lengthen, to stretch, to reach out, to grow (beard)
延びる	のびる	to be prolonged
述べる	のべる	to state, to express, to mention
上り	のぼり	up-train (going to Tokyo), ascent
上る	のぼる	to ascend, to go up, to climb
載る	のる	to appear (in print), to be recorded
場	ば	place, field (physics)
はい	（感）	wear, put on (sword)
梅雨	ばいう	rainy season, rain during the rainy season
配達	はいたつ	delivery, distribution
計る	はかる	to measure, to weigh, to survey
吐き気	はきけ	nausea, sickness in the stomach
履く	はく	to wear, to put on (lower body)
吐く	はく	(1) to breathe, (2) to tell (lies), (3) to vomit, to disgorge
激しい	はげしい	violent, vehement, intense
始まり	はじまり	origin, beginning
始めに	はじめに	to begin with, first of all
初めに	はじめに	
肌	はだ	skin
裸	はだか	naked, nude
二十	はたち	20 years old, 20th year
働き	はたらき	work, labor
×	ばつ	
発見	はっけん	discovery, detection, finding
発車	はっしゃ	departure of a vehicle
発想	はっそう	expression (music), conceptualization
発達	はったつ	development, growth
発明	はつめい	invention
派手	はで	showy, loud, gay, flashy, gaudy
話し掛ける	はなしかける	to accost a person, to talk (to someone)
放す	はなす	to separate, to set free
花火	はなび	fireworks
離れる	はなれる	to be separated from, to leave, to go away, to be a long way off
放れる	はなれる	to leave, to get free, to cut oneself off
母親	ははおや	mother
省く	はぶく	to omit, to eliminate, to curtail, to economize
腹	はら	abdomen, belly, stomach
原	はら	field, plain, prairie, tundra, moor, wilderness
払い戻す	はらいもどす	to repay, to pay back
針	はり	needle, hand (e.g. clock)
番	ばん	
犯罪	はんざい	crime
反省	はんせい	reflection, reconsideration, introspection, meditation, contemplation
判断	はんだん	judgement, decision
犯人	はんにん	offender, criminal
販売	はんばい	sale, selling, marketing
日当たり	ひあたり	exposure to the sun, sunny place
比較	ひかく	comparison
比較的	ひかくてき	comparatively, relatively
膝	ひざ	knee, lap
非常	ひじょう	emergency, extraordinary, unusual
美人	びじん	beautiful person (woman)
額	ひたい	forehead, brow
日付	ひづけ	date, dating
必死	ひっし	inevitable death, desperation, frantic, inevitable result
一通り	ひととおり	ordinary, usual, in general, briefly
独り言	ひとりごと	a soliloquy, a monologue, speaking to oneself
一人一人	ひとりひとり	one by one, each, one at a time
日日	ひにち	every day, daily, day after day
批判	ひはん	criticism, judgement, comment
秘密	ひみつ	secret, secrecy
微妙	びみょう	delicate, subtle
紐	ひも	(1) string, cord, (2) pimp
費用	ひよう	cost, expense
表	ひょう	table (e.g. Tab 1), chart, list
美容	びよう	beauty of figure or form
評価	ひょうか	valuation, estimation, assessment, evaluation
表現	ひょうげん	expression, presentation, representation (math)
広がる	ひろがる	to spread (out), to extend, to stretch, to reach to, to get around
広げる	ひろげる	to spread, to extend, to expand, to enlarge
広さ	ひろさ	extent
品	ひん	thing, article, goods, dignity, article (goods), counter for meal courses
不	ふ	un, non, negative prefix
不	ぶ	un, non, negative prefix
無	ぶ	nothing, naught, nil, zero
分	ぶ	dividing, part
不安	ふあん	anxiety, uneasiness, insecurity, suspense
風景	ふうけい	scenery
夫婦	ふうふ	married couple, husband and wife
武器	ぶき	weapon, arms, ordinance
付近	ふきん	neighbourhood, vicinity, environs
服装	ふくそう	garments
含む	ふくむ	to hold in the mouth, to bear in mind
含める	ふくめる	to include, to instruct, to make one understand
膨らむ	ふくらむ	to expand, to swell (out), to get big, to become inflated
袋	ふくろ	bag, sack
不幸	ふこう	unhappiness, sorrow, misfortune, disaster, accident, death
無事	ぶじ	safety, peace, quietness
不思議	ふしぎ	mystery, curiosity
不自由	ふじゆう	discomfort, disability, inconvenience, destitution
防ぐ	ふせぐ	to defend (against), to protect, to prevent
不足	ふそく	insufficiency, shortage, deficiency, lack, dearth
再び	ふたたび	again, once more, a second time
普段	ふだん	usually, habitually, ordinarily, always
打つ	ぶつ	to hit, to strike
物価	ぶっか	prices of commodities, prices (in general)
物質	ぶっしつ	material, substance
船	ふね	ship, boat, watercraft, shipping, vessel, steamship
部品	ぶひん	parts, accessories
部分	ぶぶん	portion, section, part
父母	ふぼ	father and mother, parents
不満	ふまん	dissatisfaction, displeasure, discontent, complaints, unhappiness
増やす	ふやす	to increase, to add to, to augment
分	ぶん	dividing, part, segment
文	ぶん	sentence
雰囲気	ふんいき	atmosphere (e.g. musical), mood, ambience
平日	へいじつ	weekday, ordinary days
平和	へいわ	peace, harmony
別荘	べっそう	holiday house, villa
別に	べつに	(not) particularly, nothing
別々	べつべつ	separately, individually
減らす	へらす	to abate, to decrease, to diminish, to shorten
減る	へる	to decrease (in size or number), to diminish, to abate
変化	へんか	goblin, ghost, apparition, bugbear
勉強	べんきょう	study, diligence, discount, reduction
変更	へんこう	change, modification, alteration
編集	へんしゅう	editing, compilation, editorial (e.g. committee)
弁当	べんとう	box lunch
方	ほう	side
法	ほう	Act (law: the X Act)
棒	ぼう	pole, rod, stick
方向	ほうこう	direction, course, way
放送	ほうそう	broadcast, broadcasting
方法	ほうほう	method, manner, way, means, technique
放る	ほうる	to let go
他	ほか	other (esp. places and things)
外	ほか	other place, the rest
保健	ほけん	health preservation, hygiene, sanitation
誇り	ほこり	pride
保証	ほしょう	guarantee, security, assurance, pledge, warranty
程	ほど	degree, extent, bounds, limit
骨	ほね	bone
炎	ほのお	flame
頬	ほほ	cheek (of face)
微笑む	ほほえむ	to smile
褒める	ほめる	to praise, to admire, to speak well
本当	ほんと	truth, reality
本当	ほんとう	truth, reality
本人	ほんにん	the person himself
間	ま	space, room, time, pause
迷子	まいご	lost (stray) child
巻く	まく	to wind, to coil, to roll
負け	まけ	defeat, loss, losing (a game)
摩擦	まさつ	friction, rubbing, rubdown, chafe
真面目	まじめ	diligent, serious, honest
混じる	まじる	to be mixed, to be blended with, to associate with
貧しい	まずしい	poor, needy
間違い	まちがい	mistake
真っ赤	まっか	deep red, flushed (of face)
真っ暗	まっくら	total darkness, shortsightedness, pitch dark
真っ黒	まっくろ	pitch black
真っ青	まっさお	deep blue, ghastly pale
真っ白	まっしろ	pure white
窓口	まどぐち	ticket window
学ぶ	まなぶ	to study (in depth), to learn, to take lessons in
真似	まね	mimicry, imitation, behavior, pretense
真似る	まねる	to mimic, to imitate
豆	まめ	beans, peas
間も無く	まもなく	soon, before long, in a short time
守る	まもる	to protect, to obey, to guard, to abide (by the rules)
丸	まる	circle, full (month), perfection, purity, suffix for ship names
円	まる	circle, money
丸い	まるい	round, circular, spherical
円い	まるい	round, circular, spherical
回す	まわす	to turn, to revolve
回り	まわり	circumference, surroundings, circulation
万一	まんいち	by some chance, by some possibility, if by any chance, 10E4:1 odds
満員	まんいん	full house, no vacancy, sold out
満足	まんぞく	satisfaction
身	み	body, main part, oneself, sword
実	み	fruit, nut, seed, content, good result
見下ろす	みおろす	to overlook, to command a view of, to look down on something
見出し	みだし	heading, caption, subtitle, index
満ちる	みちる	to be full, to rise (tide), to mature, to expire
密	みつ	
見直す	みなおす	to look again, to get a better opinion of
未満	みまん	less than, insufficient
都	みやこ	capital
妙	みょう	strange, unusual
未来	みらい	future (life, tense)
ミリ	（メートル）	milli-, 10^-3
見る	みる	to see, to watch
診る	みる	to examine (medical)
無	む	nothing, naught, nil, zero
無視	むし	disregard, ignore
虫歯	むしば	cavity, tooth decay, decayed tooth, caries
矛盾	むじゅん	contradiction, inconsistency
無数	むすう	countless number, infinite number
結ぶ	むすぶ	to tie, to bind, to link
無駄	むだ	futility, uselessness
夢中	むちゅう	daze, (in a) trance, ecstasy, delirium, engrossment
胸	むね	breast, chest
無料	むりょう	free, no charge
群れ	むれ	group, crowd, flock, herd
名詞	めいし	noun
迷惑	めいわく	trouble, bother, annoyance
目上	めうえ	superior(s), senior
巡る	めぐる	to go around
目下	めした	at present, now
目立つ	めだつ	to be conspicuous, to stand out
面	めん	face, mug, surface, facial features, mask, face guard, side or facet, corner, page
申し訳ない	もうしわけない	inexcusable
燃える	もえる	to burn
目的	もくてき	purpose, goal, aim, objective, intention
目標	もくひょう	mark, objective, target
木曜	もくよう	Thursday
文字	もじ	letter (of alphabet), character
最も	もっとも	most, extremely
元	もと	(1) origin, original, (2) former
基	もと	basis
素	もと	prime
戻す	もどす	to restore, to put back, to return
求める	もとめる	to seek, to request, to demand, to want, to wish for, to search for, to pursue (pleasure), to hunt (a job), 元々	もともと	originally, by nature, from the start
者	もの	person
物語	ものがたり	tale, story, legend
物語る	ものがたる	to tell, to indicate
紅葉	もみじ	(1) (Japanese) maple
盛る	もる	(1) to serve (food, etc.), (2) to fill up, (3) to prescribe
文句	もんく	phrase, complaint
役人	やくにん	government official
役目	やくめ	duty, business
役割	やくわり	part, assigning (allotment of) parts, role, duties
家賃	やちん	rent
破る	やぶる	to tear, to violate, to defeat, to smash, to destroy
破れる	やぶれる	to get torn, to wear out
唯一	ゆいいつ	only, sole, unique
遊園地	ゆうえんち	amusement park
優秀	ゆうしゅう	superiority, excellence
友人	ゆうじん	friend
郵便	ゆうびん	mail, postal service
愉快	ゆかい	pleasant, happy
浴衣	ゆかた	bathrobe, informal summer kimono, yukata
譲る	ゆずる	to turn over, to assign, to hand over
豊か	ゆたか	abundant, wealthy, plentiful, rich
緩い	ゆるい	loose, lenient, slow
許す	ゆるす	to permit, to allow, to approve
夜	よ	evening, night
夜明け	よあけ	dawn, daybreak
様	よう	way, manner, kind
酔う	よう	to get drunk, to become intoxicated
要求	ようきゅう	request, demand, requisition
幼児	ようじ	infant, baby, child
様子	ようす	aspect, state, appearance
要領	ようりょう	point, gist, essentials, outline
予期	よき	expectation, assume will happen, forecast
余計	よけい	too much, unnecessary, abundance, surplus, excess, superfluity
予算	よさん	estimate, budget
寄せる	よせる	to collect, to gather, to add, to put aside
酔っ払い	よっぱらい	drunkard
夜中	よなか	midnight, dead of night
世の中	よのなか	society, the world, the times
予備	よび	preparation, preliminaries, reserve, spare
呼び出す	よびだす	to summon, to call (e.g. phone)
予報	よほう	forecast, prediction
読み	よみ	reading
余裕	よゆう	surplus, composure, margin, room, time, allowance, scope, rope
喜び	よろこび	(a) joy, (a) delight, rapture, pleasure, gratification, rejoicing, congratulations, felicitations
よろしく	（感）	well, properly, suitably, best regards, please remember me
四	よん	four
来	らい, for (10 days), next (year)
楽	らく	comfort, ease
乱暴	らんぼう	rude, violent, rough, lawless, unreasonable, reckless
理解	りかい	understanding, comprehension
離婚	りこん	divorce
理想	りそう	ideal
率	りつ	rate, ratio, proportion, percentage
立派	りっぱ	splendid, fine, handsome, elegant, imposing, prominent, legal, legitimate
留学	りゅうがく	studying abroad
流行	りゅうこう	fashionable, fad, in vogue, prevailing
料金	りょうきん	fee, charge, fare
例	れい	instance, example, case
礼	れい	expression of gratitude
礼儀	れいぎ	manners, courtesy, etiquette
冷静	れいせい	calm, composure, coolness, serenity
列	れつ	queue, line, row
列車	れっしゃ	train (ordinary)
練習	れんしゅう	practice
連想	れんそう	association (of ideas), suggestion
連続	れんぞく	serial, consecutive, continuity, continuing
老人	ろうじん	the aged, old person
労働	ろうどう	manual labor, toil, work
録音	ろくおん	(audio) recording
論文	ろんぶん	thesis, essay, treatise, paper
和英	わえい	Japanese-English
分かれる	わかれる	to branch off, to diverge from, to fork, to split, to dispense, to scatter, to divide into
脇	わき	side
話題	わだい	topic, subject
笑い	わらい	laugh, laughter, smile
割引	わりびき	discount, reduction, rebate
間	あいだ	a space
合う	あう	to match
空く	あく	to open, to become empty
明日	あす	tomorrow
遊び	あそび	play
集る	あつまる	to gather
集める	あつめる	to collect something
謝る	あやまる	to apologize
安心	あんしん	relief
安全	あんぜん	safety
案内	あんない・する	to guide
以下	いか	less than
以外	いがい	with the exception of
医学	いがく	medical science
生きる	いきる	to live
意見	いけん	opinion
石	いし	stone
以上	いじょう	more than, this is all
一度	いちど	once
一生懸命	いっしょうけんめい	with utmost effort
糸	いと	thread
田舎	いなか	countryside
受ける	うける	to take a lesson or test
動く	うごく	to move
打つ	うつ	to hit
美しい	うつくしい	beautiful
写す	うつす	to copy or photograph
移る	うつる	to move house or transfer
腕	うで	arm
裏	うら	reverse side
売り場	うりば	place where things are sold
運転	うんてん・する	to drive
運転手	うんてんしゅ	driver
運動	うんどう・する	to exercise
選ぶ	えらぶ	to choose
お祝い	おいわい	congratulation
贈り物	おくりもの	gift
送る	おくる	to send
遅れる	おくれる	to be late
行う	おこなう	to do
お宅	おたく	(polite) your house
夫	おっと	husband
音	おと	sound, note
お祭り	おまつり	festival
思い出す	おもいだす	to remember
思う	おもう	to think, to feel
表	おもて	the front
親	おや	parents
お礼	おれい	expression of gratitude
折れる	おれる	to break or be folded
終わり	おわり	the end
海岸	かいがん	coast
会議	かいぎ	meeting
会議室	かいぎしつ	meeting room
会場	かいじょう	assembly hall or meeting place
会話	かいわ	conversation
帰り	かえり	return
変える	かえる	to change
掛ける	かける	to hang something
火事	かじ	fire
堅/硬/固い	かたい	hard
形	かたち	shape
片付ける	かたづける	to tidy up
課長	かちょう	section manager
勝つ	かつ	to win
家内	かない	housewife
必ず	かならず	certainly, necessarily
お・金持ち	かねもち/おかねもち	rich man
彼女	かのじょ	she, girlfriend
壁	かべ	wall
髪	かみ	hair
噛む	かむ	to bite, to chew
彼	かれ	he, boyfriend
彼ら	かれら	they
代わり	かわり	substitute, alternate
変わる	かわる	to change
考える	かんがえる	to consider
関係	かんけい	relationship
簡単	かんたん	simple
気	き	spirit, mood
機会	きかい	opportunity
危険	きけん	danger
聞こえる	きこえる	to be heard
汽車	きしゃ	steam train
技術	ぎじゅつ	art, technology, skill
季節	きせつ	season
規則	きそく	regulations
気分	きぶん	mood
君	きみ	(informal) You (used by men towards women)
決める	きめる	to decide
気持ち	きもち	feeling, mood
着物	きもの	kimono
客	きゃく	guest, customer
急	きゅう	urgent, steep
急行	きゅうこう	speedy, express
教育	きょういく	education
興味	きょうみ	an interest
近所	きんじょ	neighbourhood
具合	ぐあい	condition, health
空気	くうき	air, atmosphere
空港	くうこう	airport
草	くさ	grass
首	くび	neck
雲	くも	cloud
比べる	くらべる	to compare
君	くん	suffix for familiar young male
毛	け	hair or fur
計画	けいかく・する	to plan
経験	けいけん・する	to experience
経済	けいざい	finance, economy
警察	けいさつ	police
景色	けしき	scene, landscape
消しゴム	けしゴム	eraser
決して	けっして	never
原因	げんいん	cause, source
研究	けんきゅう	research
研究室	けんきゅうしつ	study room, laboratory
子	こ	child
郊外	こうがい	outskirts
講義	こうぎ	lecture
工業	こうぎょう	the manufacturing industry
高校	こうこう	high school
高校生	こうこうせい	high school student
工場	こうじょう	factory
校長	こうちょう	headmaster
交通	こうつう	traffic, transportation
公務員	こうむいん	government worker
国際	こくさい	international
心	こころ	core, heart
故障	こしょう・する	to break-down
ご存じ	ごぞんじ	knowing, acquaintance
答	こたえ	response
細かい	こまかい	small, fine
込む	こむ	to be crowded
米	こめ	uncooked rice
怖い	こわい	frightening
今度	こんど	now, next time
今夜	こんや	tonight
最近	さいきん	latest, nowadays
最後	さいご	last, end
最初	さいしょ	beginning, first
探す	さがす	to look for
下げる	さげる	to hang, to lower, to move back
さ来月	さらいげつ	the month after next
さ来週	さらいしゅう	the week after next
触る	さわる	to touch
残念	ざんねん	disappointment
市	し	city
字	じ	character
試合	しあい	match, game
仕方	しかた	method
試験	しけん	examination
事故	じこ	accident
時代	じだい	era
下着	したぎ	underwear
失敗	しっぱい	failure, mistake
島	しま	island
市民	しみん	citizen
事務所	じむしょ	office
社会	しゃかい	society, public
社長	しゃちょう	company president
自由	じゆう	freedom
習慣	しゅうかん	custom, manners
住所	じゅうしょ	an address, a residence
十分	じゅうぶん	enough
出席	しゅっせき・する	to attend
出発	しゅっぱつ・する	to depart
準備	じゅんび・する	to prepare
紹介	しょうかい	introduction
小学校	しょうがっこう	elementary school
小説	しょうせつ	novel
承知	しょうち・する	to consent
将来	しょうらい	future, prospects
食事	しょくじ・する	to have a meal
女性	じょせい	woman
知らせる	しらせる	to notify
調べる	しらべる	to investigate
人口	じんこう	population
神社	じんじゃ	Shinto shrine
親切	しんせつ	kindness
水泳	すいえい	swimming
水道	すいどう	water supply
数学	すうがく	mathematics, arithmetic
過ぎる	すぎる	to exceed
捨てる	すてる	to throw away
砂	すな	sand
済む	すむ	to finish
生活	せいかつ・する	to live
生産	せいさん・する	to produce
世界	せかい	the world
席	せき	seat
説明	せつめい	explanation
背中	せなか	back of the body
世話	せわ・する	to look after
戦争	せんそう	war
先輩	せんぱい	senior
相談	そうだん・する	to discuss
育てる	そだてる	to rear, to bring up
祖父	そふ	grandfather
祖母	そぼ	grandmother
大学生	だいがくせい	university student
大事	だいじ	important, valuable, serious matter
大体	だいたい	generally
大分	だいぶ	greatly
台風	たいふう	typhoon
倒れる	たおれる	to break down
確か	たしか	definite
尋ねる	たずねる	to ask
正しい	ただしい	correct
立てる	たてる	to stand something up
建てる	たてる	to build
例えば	たとえば	for example
楽しみ	たのしみ	joy
足りる	たりる	to be enough
男性	だんせい	male
血	ち	blood
力	ちから	strength, power
注意	ちゅうい	caution
中学校	ちゅうがっこう	junior high school, middle school
駐車場	ちゅうしゃじょう	parking lot
捕まえる	つかまえる	to seize
付く	つく	to be attached
都合	つごう	circumstances, convenience
伝える	つたえる	to report
続く	つづく	to be continued
続ける	つづける	to continue
包む	つつむ	to wrap
妻	つま	(humble) wife
連れる	つれる	to lead
丁寧	ていねい	polite
適当	てきとう	suitability
手伝う	てつだう	to assist
手袋	てぶくろ	glove
寺	てら	temple
点	てん	point, dot
店員	てんいん	shop assistant
天気予報	てんきよほう	weather forecast
都	と	metropolitan
道具	どうぐ	tool, means
動物園	どうぶつえん	zoo
遠く	とおく	distant
通る	とおる	to go through
特に	とくに	particularly, especially
特別	とくべつ	special
途中	とちゅう	on the way
特急	とっきゅう	limited express train (faster than an express train)
届ける	とどける	to reach
止める	とめる	to stop something
泥棒	どろぼう	thief
直す	なおす	to fix, to repair
泣く	なく	to weep
無くなる	なくなる	to disappear, to get lost
亡くなる	なくなる	to die
投げる	なげる	to throw or cast away
鳴る	なる	to sound
慣れる	なれる	to grow accustomed to
逃げる	にげる	to escape
日記	にっき	journal
入院	にゅういん・する	to hospitalise
入学	にゅうがく・する	to enter school or university
似る	にる	to be similar
人形	にんぎょう	doll, figure
熱	ねつ	fever
眠い	ねむい	sleepy
眠る	ねむる	to sleep
残る	のこる	to remain
乗り換える	のりかえる	to change between buses or trains
乗り物	のりもの	vehicle
葉	は	leaf
場合	ばあい	situation
倍	ばい	double
運ぶ	はこぶ	to transport
始める	はじめる	to begin
場所	ばしょ	location
恥ずかしい	はずかしい	embarrassed
発音	はつおん	pronunciation
花見	はなみ	cherry-blossom viewing
払う	はらう	to pay
番組	ばんぐみ	television or radio program
反対	はんたい	opposition
日	ひ	day, sun
火	ひ	fire
光	ひかり	light
光る	ひかる	to shine, to glitter
引き出し	ひきだし	drawer, drawing out
引き出す	ひきだす	to withdraw
久しぶり	ひさしぶり	after a long time
美術館	びじゅつかん	art gallery
非常に	ひじょうに	extremely
引っ越す	ひっこす	to move house
必要	ひつよう	necessary
開く	ひらく	to open an event
昼間	ひるま	daytime, during the day
増える	ふえる	to increase
深い	ふかい	deep
複雑	ふくざつ	complexity, complication
復習	ふくしゅう	revision
部長	ぶちょう	head of a section
普通	ふつう	usually, or a train that stops at every station
太る	ふとる	to become fat
不便	ふべん	inconvenience
踏む	ふむ	to step on
文化	ぶんか	culture
文学	ぶんがく	literature
文法	ぶんぽう	grammar
別	べつ	different
変	へん	strange
返事	へんじ	reply
放送	ほうそう・する	to broadcast
法律	ほうりつ	law
僕	ぼく	I (used by males)
星	ほし	star
負ける	まける	to lose
間違える	まちがえる	to make a mistake
間に合う	まにあう	to be in time for
回る	まわる	to go around
漫画	まんが	comic
見える	みえる	to be in sight
見つかる	みつかる	to be discovered
見つける	みつける	to discover
向かう	むかう	to face
迎える	むかえる	to go out to meet
昔	むかし	olden days, former
虫	むし	insect
息子	むすこ	(humble) son
無理	むり	impossible
召し上がる	めしあがる	(polite) to eat
珍しい	めずらしい	rare
戻る	もどる	to turn back
森	もり	forest
焼く	やく	to bake, to grill
約束	やくそく	promise
役に立つ	やくにたつ	to be helpful
焼ける	やける	to burn, to be roasted
優しい	やさしい	kind
止める	やめる	to stop
柔らかい	やわらかい	soft
指	ゆび	finger
夢	ゆめ	dream
揺れる	ゆれる	to shake, to sway
用	よう	use
用意	ようい	preparation
用事	ようじ	things to do
汚れる	よごれる	to get dirty
予定	よてい	arrangement
予約	よやく	reservation
喜ぶ	よろこぶ	to be delighted
理由	りゆう	reason
利用	りよう	utilization
両方	りょうほう	both sides
旅館	りょかん	Japanese hotel
留守	るす	absence
連絡	れんらく	contact
別れる	わかれる	to separate
沸く	わく	to boil, to grow hot, to get excited
訳	わけ	meaning, reason
忘れ物	わすれもの	lost article
笑う	わらう	to laugh, to smile
会う	あう	to meet
青	あお	blue
青い	あおい	blue
赤	あか	red
赤い	あかい	red
秋	あき	autumn
開く	あく	to open, to become open
開ける	あける	to open
上げる	あげる	to give
朝	あさ	morning
足	あし	foot, leg
明日	あした	tomorrow
遊ぶ	あそぶ	to play, to make a visit
暖かい	あたたかい	warm
頭	あたま	head
新しい	あたらしい	new
熱い	あつい	hot to the touch
厚い	あつい	kind, deep, thick
後	あと	afterwards
兄	あに	(humble) older brother
姉	あね	(humble) older sister
危ない	あぶない	dangerous
甘い	あまい	sweet
雨	あめ	rain
洗う	あらう	to wash
言う	いう	to say
家	いえ	house
行く	いく	to go
池	いけ	pond
医者	いしゃ	medical doctor
忙しい	いそがしい	busy, irritated
痛い	いたい	painful
一	いち	one
一日	いちにち	first of the month
五日	いつか	five days, fifth day
一緒	いっしょ	together
五つ	いつつ	five
犬	いぬ	dog
今	いま	now
意味	いみ	meaning
嫌	いや	unpleasant
入口	いりぐち	entrance
入れる	いれる	to put in
色	いろ	colour
上	うえ	on top of
後ろ	うしろ	behind
薄い	うすい	thin, weak
歌	うた	song
歌う	うたう	to sing
生まれる	うまれる	to be born
海	うみ	sea
売る	うる	to sell
絵	え	picture
映画	えいが	movie
映画館	えいがかん	cinema
英語	えいご	English language
駅	えき	station
多い	おおい	many
大きい	おおきい	big
大きな	おおきな	big
大勢	おおぜい	great number of people
お母さん	おかあさん	(honorable) mother
お菓子	おかし	sweets, candy
お金	おかね	money
起きる	おきる	to get up
置く	おく	to put
奥さん	おくさん	(honorable) wife
お酒	おさけ	alcohol, rice wine
お皿	おさら	plate, dish
教える	おしえる	to teach, to tell
押す	おす	to push, to stamp something
お茶	おちゃ	green tea
お手洗い	おてあらい	bathroom
お父さん	おとうさん	(honorable) father
弟	おとうと	younger brother
男	おとこ	man
男の子	おとこのこ	boy
一昨日	おととい	day before yesterday
大人	おとな	adult
同じ	おなじ	same
お兄さん	おにいさん	(honorable) older brother
お姉さん	おねえさん	(honorable) older sister
伯母さん/叔母さん	おばさん	aunt
お弁当	おべんとう	boxed lunch
覚える	おぼえる	to remember
重い	おもい	heavy
泳ぐ	およぐ	to swim
降りる	おりる	to get off, to descend
終る	おわる	to finish
音楽	おんがく	music
女	おんな	woman
女の子	おんなのこ	girl
外国	がいこく	foreign country
外国人	がいこくじん	foreigner
会社	かいしゃ	company
階段	かいだん	stairs
買い物	かいもの	shopping
買う	かう	to buy
返す	かえす	to return something
帰る	かえる	to go back
書く	かく	to write
学生	がくせい	student
傘	かさ	umbrella
貸す	かす	to lend
風	かぜ	wind
風邪	かぜ	a cold
家族	かぞく	family
方	かた	person, way of doing
学校	がっこう	school
角	かど	a corner
紙	かみ	paper
火曜日	かようび	Tuesday
辛い	からい	spicy
体	からだ	body
軽い	かるい	light
川/河	かわ	river
木	き	tree, wood
黄色	きいろ	yellow
黄色い	きいろい	yellow
消える	きえる	to disappear
聞く	きく	to hear, to listen to, to ask
北	きた	north
汚い	きたない	dirty
喫茶店	きっさてん	coffee lounge
九	きゅう / く	nine
牛肉	ぎゅうにく	beef
牛乳	ぎゅうにゅう	milk
今日	きょう	today
教室	きょうしつ	classroom
兄弟	きょうだい	(humble) siblings
去年	きょねん	last year
嫌い	きらい	hate
切る	きる	to cut
着る	きる	to put on from the shoulders down
銀行	ぎんこう	bank
金曜日	きんようび	Friday
薬	くすり	medicine
口	くち	mouth, opening
靴	くつ	shoes
靴下	くつした	socks
国	くに	country
曇り	くもり	cloudy weather
曇る	くもる	to become cloudy, to become dim
暗い	くらい	gloomy
来る	くる	to come
車	くるま	car, vehicle
黒	くろ	black
黒い	くろい	black
警官	けいかん	policeman
今朝	けさ	this morning
消す	けす	to erase, to turn off power
結婚	けっこん	marriage
玄関	げんかん	entry hall
元気	げんき	health, vitality
五	ご	five
公園	こうえん	park
交差点	こうさてん	intersection
紅茶	こうちゃ	black tea
交番	こうばん	police box
声	こえ	voice
午後	ごご	afternoon
九日	ここのか	nine days, ninth day
九つ	ここのつ	nine
午前	ごぜん	morning
答える	こたえる	to answer
今年	ことし	this year
言葉	ことば	word, language
子供	こども	child
困る	こまる	to be worried
今月	こんげつ	this month
今週	こんしゅう	this week
今晩	こんばん	this evening
魚	さかな	fish
先	さき	the future, previous
咲く	さく	to bloom
作文	さくぶん	composition, writing
差す	さす	to stretch out hands, to raise an umbrella
雑誌	ざっし	magazine
寒い	さむい	cold
さ来年	さらいねん	year after next
三	さん	three
散歩	さんぽする	to stroll
四	し / よん	four
時間	じかん	time
仕事	しごと	job
辞書	じしょ	dictionary
静か	しずか	quiet
下	した	below
七	しち / なな	seven
質問	しつもん	question
自転車	じてんしゃ	bicycle
自動車	じどうしゃ	automobile
死ぬ	しぬ	to die
自分	じぶん	oneself
閉まる	しまる	to close, to be closed
閉める	しめる	to close something
締める	しめる	to tie
写真	しゃしん	photograph
十	じゅう とお	ten
授業	じゅぎょう	lesson, class work
宿題	しゅくだい	homework
上手	じょうず	skillful
丈夫	じょうぶ	strong, durable
食堂	しょくどう	dining hall
知る	しる	to know
白	しろ	white
白い	しろい	white
新聞	しんぶん	newspaper
水曜日	すいようび	Wednesday
吸う	すう	to smoke, to suck
好き	すき	likeable
少ない	すくない	a few
少し	すこし	few
涼しい	すずしい	refreshing
住む	すむ	to live in
座る	すわる	to sit
背	せ	height, stature
生徒	せいと	pupil
狭い	せまい	narrow
千	せん	thousand
先月	せんげつ	last month
先週	せんしゅう	last week
先生	せんせい	teacher, doctor
全部	ぜんぶ	all
外	そと	outside
空	そら	sky
大学	だいがく	university
大丈夫	だいじょうぶ	all right
大好き	だいすき	to be very likeable
台所	だいどころ	kitchen
高い	たかい	tall, expensive
出す	だす	to put out
立つ	たつ	to stand
建物	たてもの	building
楽しい	たのしい	enjoyable
頼む	たのむ	to ask
食べ物	たべもの	food
食べる	たべる	to eat
卵	たまご	egg
誰	だれ	who
誰	だれか	somebody
誕生日	たんじょうび	birthday
小さい	ちいさい	little
小さな	ちいさな	little
近い	ちかい	near
違う	ちがう	to differ
近く	ちかく	near
地下鉄	ちかてつ	underground train
地図	ちず	map
茶色	ちゃいろ	brown
一日	ついたち	first of month
使う	つかう	to use
疲れる	つかれる	to get tired
次	つぎ	next
着く	つく	to arrive at
机	つくえ	desk
作る	つくる	to make
勤める	つとめる	to work for someone
冷たい	つめたい	cold to the touch
強い	つよい	powerful
手	て	hand
出かける	でかける	to go out
手紙	てがみ	letter
出口	でぐち	exit
出る	でる	to appear, to leave
天気	てんき	weather
電気	でんき	electricity, electric light
電車	でんしゃ	electric train
電話	でんわ	telephone
動物	どうぶつ	animal
遠い	とおい	far
十日	とおか	ten days, the tenth day
時々	ときどき	sometimes
時計	とけい	watch, clock
所	ところ	place
年	とし	year
図書館	としょかん	library
隣	となり	next door to
飛ぶ	とぶ	to fly, to hop
止まる	とまる	to come to a halt
土曜日	どようび	Saturday
鳥	とり	bird
とり肉	とりにく	chicken meat
取る	とる	to take something
撮る	とる	to take a photo or record a film
中	なか	middle
長い	ながい	long
鳴く	なく	animal noise. to chirp, roar or croak etc.
無くす	なくす	to lose something
夏	なつ	summer
夏休み	なつやすみ	summer holiday
七つ	ななつ	seven
七日	なのか	seven days, the seventh day
名前	なまえ	name
習う	ならう	to learn
並ぶ	ならぶ	to line up, to stand in a line
並べる	ならべる	to line up, to set up
何	なん/なに	what
二	に	two
賑やか	にぎやか	bustling, busy
肉	にく	meat
西	にし	west
日曜日	にちようび	Sunday
荷物	にもつ	luggage
猫	ねこ	cat
寝る	ねる	to go to bed, to sleep
登る	のぼる	to climb
飲み物	のみもの	a drink
飲む	のむ	to drink
乗る	のる	to get on, to ride
歯	は	tooth
入る	はいる	to enter, to contain
箱	はこ	box
橋	はし	bridge
始まる	はじまる	to begin
初め/始め	はじめ	beginning
初めて	はじめて	for the first time
走る	はしる	to run
二十歳	はたち	20 years old, 20th year
働く	はたらく	to work
八	はち	eight
二十日	はつか	twenty days, twentieth
花	はな	flower
鼻	はな	nose
話	はなし	talk, story
話す	はなす	to speak
早い	はやい	early
速い	はやい	quick
春	はる	spring
晴れ	はれ	clear weather
晴れる	はれる	to be sunny
半	はん	half
晩	ばん	evening
番号	ばんごう	number
半分	はんぶん	half minute
引く	ひく	to pull
弾く	ひく	to play an instrument with strings, including piano
低い	ひくい	short, low
飛行機	ひこうき	aeroplane
左	ひだり	left hand side
人	ひと	person
一つ	ひとつ	one
一月	ひとつき	one month
一人	ひとり	one person
暇	ひま	free time
百	ひゃく	hundred
病院	びょういん	hospital
病気	びょうき	illness
昼	ひる	noon, daytime
広い	ひろい	spacious, wide
封筒	ふうとう	envelope
吹く	ふく	to blow
服	ふく	clothes
二つ	ふたつ	two
豚肉	ぶたにく	pork
二人	ふたり	two people
二日	ふつか	two days, second day of the month
太い	ふとい	fat
冬	ふゆ	winter
降る	ふる	to fall, e.g. rain or snow
古い	ふるい	old (not used for people)
文章	ぶんしょう	sentence, text
下手	へた	unskillful
部屋	へや	room
辺	へん	area
勉強	べんきょうする	to study
便利	べんり	useful, convenient
帽子	ぼうし	hat
欲しい	ほしい	want
細い	ほそい	thin
本	ほん	book
本棚	ほんだな	bookshelves
毎朝	まいあさ	every morning
毎月	まいげつ/まいつき	every month
毎週	まいしゅう	every week
毎日	まいにち	every day
毎年	まいねん/まいとし	every year
毎晩	まいばん	every night
前	まえ	before
曲る	まがる	to turn, to bend
町	まち	town, city
待つ	まつ	to wait
窓	まど	window
丸い/円い	まるい	round, circular
万	まん	ten thousand
右	みぎ	right side
短い	みじかい	short
水	みず	water
店	みせ	shop
見せる	みせる	to show
道	みち	street
三日	みっか	three days, third day of the month
三つ	みっつ	three
皆さん	みなさん	everyone
南	みなみ	south
耳	みみ	ear
見る 観る	みる	to see, to watch
六日	むいか	six days, sixth day of the month
向こう	むこう	over there
難しい	むずかしい	difficult
六つ	むっつ	six
村	むら	village
目	め	eye
眼鏡	めがね	glasses
もう一度	もういちど	again
木曜日	もくようび	Thursday
持つ	もつ	to hold
物	もの	thing
門	もん	gate
問題	もんだい	problem
八百屋	やおや	greengrocer
安い	やすい	cheap
休み	やすみ	rest, holiday
休む	やすむ	to rest
八つ	やっつ	eight
山	やま	mountain
夕方	ゆうがた	evening
夕飯	ゆうはん	dinner
郵便局	ゆうびんきょく	post office
雪	ゆき	snow
行く	ゆく	to go
八日	ようか	eight days, eighth day of the month
洋服	ようふく	western-style clothes
横	よこ	beside, side, width
四日	よっか	four days, fouth day of the month
四つ	よっつ	four
呼ぶ	よぶ	to call out, to invite
読む	よむ	to read
夜	よる	evening, night
弱い	よわい	weak
来月	らいげつ	next month
来週	らいしゅう	next week
来年	らいねん	next year
留学生	りゅうがくせい	overseas student
両親	りょうしん	both parents
料理	りょうり	cuisine
旅行	りょこう	travel
冷蔵庫	れいぞうこ	refrigerator
練習	れんしゅうする	to practice
廊下	ろうか	corridor
六	ろく	six
若い	わかい	young
分かる	わかる	to be understood
忘れる	わすれる	to forget
私	わたくし	(humble) I, myself
私	わたし	I, myself
渡す	わたす	to hand over
渡る	わたる	to go across
悪い	わるい	bad
